1 12 4034 4038 4045 4046 3991 3903 3813 3703 3637 3531 3457 3394 
1 16 3715 3658 3588 3553 3495 3415 3395 3332 3291 3222 3169 3075 3048 3047 3176 3270 
1 27 4247 4357 4452 4525 4982 4654 4723 4793 4835 4957 5042 5052 5082 5181 5307 5376 5439 5531 5538 5601 5662 5738 5766 5825 5839 5868 5765 
1 5 6011 5924 5889 5977 5998 
1 11 5868 5896 5998 6100 6140 6228 6218 6208 6310 6332 6374 
1 2 5517 5601 
1 6 5531 5523 5486 5460 5559 5647 
1 27 4247 4109 4222 4122 3962 3874 3758 3633 3563 3499 3474 3422 3358 3243 3110 3046 2957 2914 2767 2740 2670 2574 2515 2422 2407 2406 2334 
1 7 2597 2615 2583 2559 2401 2283 2285 
1 2 2536 2515 
1 25 4357 3963 4374 4300 4268 4221 4129 4015 3910 3747 3732 3617 3564 3445 3374 3324 3228 3175 3165 3094 3034 2892 2847 2753 2632 
1 3 4252 4153 4129 
1 3 4723 4794 4793 
1 3 5000 4916 4835 
1 6 3771 3677 3570 3335 4597 3090 
1 15 3090 2947 2816 2648 2517 2402 2352 2262 2195 2138 2045 1949 1916 1913 1964 
1 12 2045 2081 2072 2768 2055 2071 2174 2218 2335 2449 2551 2632 
1 7 2648 2815 2796 2826 2734 2664 2632 
1 8 2373 2408 2462 2510 2537 2509 2480 2474 
1 6 3368 3279 3268 3258 3305 3228 
1 2 3305 3444 
1 13 3732 3730 3644 3576 3493 3436 3375 3317 3238 3118 2981 2917 2826 
1 33 2517 2655 2754 2720 2808 5149 4541 2762 4690 6665 4013 3196 3260 3135 3189 6743 6526 212 5834 2317 3831 3832 3760 3745 3779 3753 3666 3586 3566 3461 3393 3350 3306 
1 13 3566 3534 3583 3642 3702 3737 3822 3871 3928 3992 4059 4060 4406 
1 3 4263 4313 4286 
1 9 4593 4554 4485 4536 4588 4518 4458 4396 4307 
1 2 4677 4588 
1 9 2876 2843 6485 2849 3019 3127 3246 3377 3394 
1 5 3270 3359 3541 3378 3377 
1 7 3903 3965 4023 4155 4242 4344 4424 
1 7 4424 4489 4562 4641 4643 4650 4593 
1 3 4805 4678 4641 
1 5 3992 3984 4070 4120 4197 
1 6 3892 3990 4028 4182 4257 4296 
1 2 3701 3753 
1 5 4436 4355 4306 4239 4257 
1 4 4355 4292 4235 4197 
1 11 4436 4453 4501 4565 4640 4770 4860 4948 5015 5049 5094 
1 7 3335 4524 3376 5193 3585 3599 212 
1 6 2892 2909 2770 2688 2598 2462 
1 17 2474 2448 2323 2310 2290 2251 2153 2108 2137 2114 2107 2167 2169 2209 2334 2258 2285 
1 7 2290 2346 2461 2576 2603 2675 2767 
1 4 2985 3088 3179 3268 
1 3 2861 2759 2598 
1 3 2861 2837 2770 
1 3 3032 2883 2861 
1 9 4039 4084 3973 3959 3917 3829 3848 3741 3658 
1 9 4023 3958 4087 3986 3879 3819 3740 3646 3553 
1 3 4034 4098 4162 
1 3 4190 4105 4046 
2 6 4406 4114 4162 4213 4286 4307 
1 4 2728 2597 2506 2406 
