1 12 4034 4038 4045 4046 3991 3903 3813 3703 3637 3531 3457 3394 
1 16 3715 3658 3588 3553 3495 3415 3395 3332 3291 3222 3169 3075 3048 3047 3176 3270 
1 19 5765 5868 5839 5825 5766 5738 5662 5601 5538 5531 5439 5376 5307 5181 5082 5052 5042 4957 4835 
1 5 6011 5924 5889 5977 5998 
1 11 5868 5896 5998 6100 6140 6228 6218 6208 6310 6332 6374 
1 2 5517 5601 
1 6 5531 5523 5486 5460 5559 5647 
1 14 2334 2406 2407 2422 2515 2574 2670 2740 2767 2914 2957 3046 3162 3243 
1 2 2536 2515 
1 24 3368 3279 3268 3258 3305 3444 3504 3564 3617 3732 3747 3910 4015 4129 4221 4268 4300 4374 4421 4452 4357 4247 4160 4009 
1 3 4252 4153 4129 
1 8 5000 4916 4835 4730 4654 4982 4525 4452 
1 6 3771 3677 3570 3335 4597 3090 
1 15 3090 2947 2816 2648 2517 2402 2352 2262 2195 2138 2045 1949 1916 1913 1964 
1 12 2045 2081 2072 2768 2055 2071 2174 2218 2335 2449 2551 2632 
1 7 2648 2815 2796 2826 2734 2664 2632 
1 8 2373 2408 2462 2510 2537 2509 2480 2474 
1 13 3732 3730 3644 3576 3493 3436 3375 3317 3238 3118 2981 2917 2826 
1 33 2517 2655 2754 2720 2808 5149 4541 2762 4690 6665 4013 3196 3260 3135 3189 6743 6526 212 5834 2317 3831 3832 3760 3745 3779 3753 3666 3586 3566 3461 3393 3350 3306 
1 13 3566 3534 3583 3642 3702 3737 3822 3871 3928 3992 4059 4060 4406 
1 9 4593 4554 4485 4536 4588 4518 4458 4396 4307 
1 2 4677 4588 
1 9 2876 2843 6485 2849 3019 3127 3246 3377 3394 
1 5 3270 3359 3541 3378 3377 
1 7 3903 3965 4023 4155 4242 4344 4424 
1 7 4424 4489 4562 4641 4643 4650 4593 
1 3 4805 4678 4641 
1 5 3992 3984 4070 4120 4197 
1 6 3892 3990 4028 4182 4257 4296 
1 2 3701 3753 
1 5 4436 4355 4306 4239 4257 
1 4 4355 4292 4235 4197 
1 11 4436 4453 4501 4565 4640 4770 4860 4948 5015 5049 5094 
1 7 3335 4524 3376 5193 3585 3599 212 
1 6 2462 2598 2688 2619 2571 2632 
1 17 2474 2448 2323 2310 2290 2251 2153 2108 2137 2114 2107 2167 2169 2209 2334 2258 2285 
1 7 2290 2346 2461 2576 2603 2675 2767 
1 4 2985 3088 3179 3268 
1 9 4039 4084 3973 3959 3917 3829 3848 3741 3658 
1 9 4023 3958 4087 3986 3879 3819 3740 3646 3553 
1 3 4034 4098 4162 
2 6 4406 4114 4162 4213 4286 4307 
1 4 2728 2597 2506 2406 
1 7 3474 3499 3563 3633 3758 3874 3962 
1 4 4160 4251 4273 4300 
1 4 3296 3330 3255 3228 
1 5 3255 3175 3165 3094 3034 
1 2 3228 3305 
1 5 2688 2770 2909 2892 3034 
1 4 5318 5284 5263 5213 
1 2 5179 5263 
1 15 4521 4415 4302 4184 4053 3918 3827 3707 3559 3480 3396 3308 3224 3223 3320 
1 50 1234 1184 1207 1273 1315 1403 1450 1542 1642 1735 1804 1915 1972 2005 2023 2058 2161 2185 2238 2245 2246 2265 2305 2306 2354 2341 2389 2342 2198 2109 2039 1970 1909 1856 1842 1778 1749 1676 1675 1588 1480 1420 1304 1209 1125 1044 952 865 806 730 
1 12 3044 3115 3178 3282 3370 3397 3512 3590 3708 3786 3782 3830 
1 12 3370 3481 3462 3433 3315 3150 3104 3005 2923 2897 2934 2936 
1 8 2354 2452 2562 2666 2763 2798 2905 2923 
1 8 2666 2665 2784 2831 2912 2961 3095 3224 
1 29 3223 3203 3171 3156 3177 3170 3383 3418 3429 3339 3313 3261 3148 3147 3076 2920 2817 2797 2698 2616 2472 2528 2434 2304 2213 2140 2141 2083 2005 
1 16 4415 4393 4414 4438 4462 4482 4688 4748 4798 4903 4937 5013 4975 4969 4962 5034 
1 4 3178 3114 3071 3150 
1 21 3433 3593 3711 3754 3865 3908 4065 4141 4227 4314 4328 4360 4363 4425 4487 4509 4631 4689 4799 4871 4962 
1 7 3711 3692 3648 3577 3650 3731 3707 
1 9 2689 2519 2647 2450 2500 2577 2633 2681 2616 
1 11 3468 3453 3417 3280 3202 3125 3035 2948 2862 2755 2681 
1 13 1390 1290 1303 1351 1418 1510 1546 1585 1617 1705 1810 1866 1903 
1 9 1866 1917 1950 2056 2116 2184 2227 2291 2450 
1 7 1683 1839 1918 1961 1968 1827 1915 
1 12 2185 2264 2366 2451 2540 2539 2638 2741 2850 2871 2885 2920 
1 10 1918 1969 2022 1998 1982 1966 1989 2012 1965 1950 
1 7 2472 2455 2303 2228 2171 2102 2022 
1 12 1315 1316 1242 1142 1098 1014 925 850 824 794 772 810 
1 36 1903 1911 1923 1896 1843 1770 1692 1616 1579 1541 1459 1391 1313 1241 1183 1043 980 912 766 743 681 614 543 482 450 401 423 403 317 351 356 385 364 334 284 229 
1 8 1984 1919 1847 1773 1632 1563 1506 1480 
1 6 1749 1764 1812 1808 1840 1847 
1 12 2342 2368 2292 2374 2286 2234 2129 2041 2024 1952 1879 1864 
1 6 2374 2438 2630 2764 2827 2936 
1 4 4414 4346 4137 4227 
1 23 4799 4872 4932 5024 3403 4964 5191 5099 3360 1409 5100 244 5029 3501 5134 3709 1084 4693 4718 2497 2894 4900 2667 
1 9 4509 4464 4371 4297 4245 4169 4026 3930 3830 
1 4 4424 7028 4454 4554 
1 3 2981 3027 3034 
1 31 1409 5234 1088 1053 5727 3674 260 4635 509 4990 392 4927 6098 437 6979 6331 6412 6421 1096 6572 6700 501 440 2652 2275 6886 618 6927 6951 6968 6985 
1 11 1213 1289 1375 1483 1554 1607 1699 1774 1861 1962 2014 
1 34 1554 1644 1710 1767 1779 1821 1816 1730 1682 1583 1527 1416 1317 1252 1181 1086 1041 949 907 885 940 1012 1047 1122 1169 1187 1232 1179 1168 1111 1011 961 915 871 
1 5 981 935 957 948 1047 
1 9 1289 1282 1337 1341 1425 1545 1665 1763 1871 
1 17 2131 2378 2221 2344 2314 2248 2093 2420 2008 3017 1742 279 1414 1598 1488 1468 1425 
1 4 3017 1880 1860 1933 
1 17 1168 1231 1281 1288 1264 1249 1255 1254 1230 1178 1138 1121 1078 1030 976 927 866 
1 14 1255 1356 1335 1378 1300 1262 1279 1368 1248 1239 1229 1221 1247 1312 
1 6 1368 1321 1406 1457 1501 1518 
1 2 1178 1262 
